#########################?#
#                         #
#                         #
#                         #
#                         #
#                         #
#                         #
#                         #
#                         #
#                         #
#                         #
#                         #
#                         #
#  #######                #
#  ##    #                #
#  #### ##                #
#       #                 #
###  #  #            ###  #
#    #  #              #  #
#@#########################
