####################
#@            # # ##
# ### ### # ### # ##
#   #   # #       ##
# # # # ####### ####
# # # #       #   ##
# # ### # ####### ##
# # #   #       # ##
# # ### # # ### # ##
# # #   # #   # # ##
# # ### # # ### # ##
# # #   # #   # # ##
# ##### # # # # # ##
# #     # # # # # ##
### # # # # ### # ##
# # # # # #       ##
# ### # ### ##  ? ##
#     #   #       ##
####################
####################
